pandemic	pandemic
quarantine	quarantine
vaccine	vaccine
vaccinated	vaccinated
lockdown	lockdown
moots	moots
corona	corona
distancing	distancing
vaccination	vaccination
virus	virus
airdrop	airdrop
yacht	yacht
masks	masks
ukraine	ukraine
vaccines	vaccines
mandates	mandates
ukrainian	ukrainian
doge	doge
staking	staking
bodybuilding	bodybuilding
manifesting	manifesting
stimulus	stimulus
liquidity	liquidity
epstein	epstein
cdc	cdc
cummings	cummings
rioters	rioters
capitol	capitol
pronouns	pronouns
closeness	closeness
blinks	blinks
obi	obi
mask	mask
caters	caters
burrow	burrow
inflation	inflation
taliban	taliban
ethiopia	ethiopia
misinformation	misinformation
socials	socials
bullish	bullish
cyberpunk	cyberpunk
vaccinations	vaccinations
disinformation	disinformation
lifestyles	lifestyles
boomer	boomer
infections	infections
musk	musk
pinks	pinks
in-person	in-person
scheduled	scheduled
zoom	zoom
infected	infected
protocols	protocols
ethiopian	ethiopian
reopening	reopening
ballots	ballots
fetishes	fetishes
mdma	mdma
minimums	minimums
scammers	scammers
crt	crt
vaccinate	vaccinate
jab	jab
sars	sars
viruses	viruses
masking	masking
telegram	telegram
whistleblower	whistleblower
greenwood	greenwood
outbreak	outbreak
mouthful	mouthful
precautions	precautions
nato	nato
azerbaijan	azerbaijan
wholesome	wholesome
immunity	immunity
tracing	tracing
folklore	folklore
arson	arson
boomers	boomers
deaths	deaths
icu	icu
impeachment	impeachment
rioting	rioting
normalize	normalize
shortages	shortages
hoax	hoax
token	token
ghosted	ghosted
sedition	sedition
moderators	moderators
respiratory	respiratory
polygon	polygon
holders	holders
verified	verified
infectious	infectious
grifter	grifter
lh	lh
prod	prod
serotonin	serotonin
billionaires	billionaires
ecosystem	ecosystem
apes	apes
trauma	trauma
tesla	tesla
performed	performed
riots	riots
distanced	distanced
concerns	concerns
clout	clout
atp	atp
decentralized	decentralized
hancock	hancock
jabs	jabs
symptoms	symptoms
roe	roe
sus	sus
ada	ada
systemic	systemic
discord	discord
generational	generational
transcribe	transcribe
shiv	shiv
bod	bod
horny	horny
minted	minted
booster	booster
attractions	attractions
herbert	herbert
hag	hag
infection	infection
sol	sol
reels	reels
resin	resin
navigator	navigator
afghanistan	afghanistan
caribbean	caribbean
truckers	truckers
discography	discography
dividend	dividend
restrictions	restrictions
stallion	stallion
unprovoked	unprovoked
virtual	virtual
grifters	grifters
ape	ape
isolate	isolate
hospitals	hospitals
investors	investors
gatherings	gatherings
moot	moot
creators	creators
filibuster	filibuster
trending	trending
fryer	fryer
euphoria	euphoria
respectfully	respectfully
grooming	grooming
investor	investor
allegedly	allegedly
protesters	protesters
fda	fda
livelihoods	livelihoods
morrison	morrison
moa	moa
apex	apex
administered	administered
cis	cis
canonically	canonically
governors	governors
authoritarian	authoritarian
transmission	transmission
variant	variant
platforms	platforms
unemployment	unemployment
doses	doses
sustainability	sustainability
automatically	automatically
bozo	bozo
flu	flu
villagers	villagers
viral	viral
protests	protests
tarot	tarot
maharashtra	maharashtra
isolation	isolation
marxist	marxist
adhd	adhd
immune	immune
clowning	clowning
scammer	scammer
isolating	isolating
marketplace	marketplace
looting	looting
parlay	parlay
buccaneers	buccaneers
fentanyl	fentanyl
commissions	commissions
equity	equity
ventilation	ventilation
dogshit	dogshit
mortality	mortality
junta	junta
requesting	requesting
carats	carats
pasting	pasting
fascist	fascist
shanks	shanks
afghan	afghan
yang	yang
ani	ani
antis	antis
moderator	moderator
minors	minors
incited	incited
bedrock	bedrock
unmatched	unmatched
verify	verify
toxic	toxic
manifest	manifest
stocks	stocks
igbo	igbo
variants	variants
curfew	curfew
reparations	reparations
polio	polio
d-day	d-day
ev	ev
tyrannical	tyrannical
trillions	trillions
herd	herd
squid	squid
audited	audited
shortage	shortage
equitable	equitable
verification	verification
myanmar	myanmar
sustainable	sustainable
absentee	absentee
caregivers	caregivers
outbreaks	outbreaks
procreate	procreate
prevention	prevention
iranian	iranian
tokens	tokens
feral	feral
measures	measures
bot	bot
chemicals	chemicals
erica	erica
debited	debited
infect	infect
monarchy	monarchy
anchor	anchor
accountable	accountable
efficacy	efficacy
well-being	well-being
pinned	pinned
yb	yb
cropping	cropping
paved	paved
chronically	chronically
communist	communist
hua	hua
sturgeon	sturgeon
cro	cro
cases	cases
hospitalized	hospitalized
zenith	zenith
armenian	armenian
projector	projector
gremlin	gremlin
normalized	normalized
traumatizing	traumatizing
narratives	narratives
streamer	streamer
audits	audits
action	action
mandate	mandate
shares	shares
overturn	overturn
traumatized	traumatized
fascism	fascism
overthrow	overthrow
bearish	bearish
draconian	draconian
imposter	imposter
landlords	landlords
pharmacies	pharmacies
postpone	postpone
karen	karen
alphabetical	alphabetical
cum	cum
arresting	arresting
hedge	hedge
vibes	vibes
fascists	fascists
massacred	massacred
china	china
narcissists	narcissists
rh	rh
freedoms	freedoms
complying	complying
mint	mint
patients	patients
models	models
governor	governor
bruno	bruno
totalitarian	totalitarian
inaction	inaction
autonomy	autonomy
project	project
normalcy	normalcy
affirmations	affirmations
narcissist	narcissist
unsolicited	unsolicited
tested	tested
peacock	peacock
businesses	businesses
swab	swab
undervalued	undervalued
uma	uma
sycophants	sycophants
chaotic	chaotic
mistreatment	mistreatment
asexual	asexual
doodles	doodles
emissions	emissions
wei	wei
interact	interact
clown	clown
checkmate	checkmate
dementia	dementia
accountability	accountability
clot	clot
brainwashed	brainwashed
virgo	virgo
unverified	unverified
earnings	earnings
essential	essential
lender	lender
metrics	metrics
interacted	interacted
boosters	boosters
reopen	reopen
cohort	cohort
villager	villager
sana	sana
atrocities	atrocities
investments	investments
pto	pto
amplify	amplify
bisexual	bisexual
dysphoria	dysphoria
autistic	autistic
gouging	gouging
workforce	workforce
lawsuits	lawsuits
dumps	dumps
parasite	parasite
ufo	ufo
elderly	elderly
contact	contact
indigenous	indigenous
theorists	theorists
halos	halos
contagious	contagious
cringe	cringe
pox	pox
supermarkets	supermarkets
mutations	mutations
sikhs	sikhs
temperature	temperature
oligarchs	oligarchs
homelessness	homelessness
censoring	censoring
earnestly	earnestly
exemptions	exemptions
cursed	cursed
legacies	legacies
protocol	protocol
sind	sind
cult	cult
plebs	plebs
injection	injection
bi	bi
charting	charting
treasure	treasure
crisis	crisis
abortion	abortion
investing	investing
suppression	suppression
karma	karma
irreversible	irreversible
banger	banger
arising	arising
medically	medically
greene	greene
