covert	covert
ane	ane
wayside	wayside
destruct	destruct
imperialism	imperialism
infringe	infringe
finalist	finalist
tongues	tongues
confidant	confidant
overuse	overuse
reducing	reducing
pearls	pearls
terminals	terminals
mavericks	mavericks
typos	typos
crosses	crosses
computing	computing
sweatshirts	sweatshirts
goofball	goofball
breakdown	breakdown
mysterious	mysterious
staircase	staircase
tampons	tampons
duke	duke
coaster	coaster
promising	promising
comrade	comrade
lotto	lotto
allure	allure
receiving	receiving
benedict	benedict
lebanon	lebanon
beautiful	beautiful
hampshire	hampshire
excludes	excludes
english	english
cram	cram
outer	outer
marked	marked
honk	honk
nature	nature
relates	relates
boyfriends	boyfriends
reversed	reversed
charade	charade
boss	boss
junkies	junkies
grapes	grapes
laundry	laundry
insidious	insidious
yahweh	yahweh
artwork	artwork
ambassador	ambassador
mr.	mr.
staffers	staffers
instill	instill
remote	remote
open-source	open-source
attribution	attribution
enthusiastic	enthusiastic
effecting	effecting
flirted	flirted
alps	alps
statutory	statutory
blisters	blisters
travesty	travesty
yrs	yrs
bran	bran
awakens	awakens
armys	armys
golf	golf
economical	economical
friday	friday
bb	bb
quarter	quarter
loosing	loosing
eerily	eerily
arcane	arcane
flattened	flattened
twitters	twitters
ringer	ringer
viewed	viewed
unfavorable	unfavorable
recruiters	recruiters
heartache	heartache
prolific	prolific
reappear	reappear
cactus	cactus
sailors	sailors
cocktail	cocktail
steal	steal
currency	currency
overtaken	overtaken
gobsmacked	gobsmacked
sacrifices	sacrifices
elf	elf
strapped	strapped
sloppy	sloppy
lads	lads
turkeys	turkeys
tracking	tracking
redirected	redirected
settlers	settlers
tethered	tethered
admiration	admiration
sharpie	sharpie
easiest	easiest
tiles	tiles
shipped	shipped
tweeting	tweeting
taller	taller
raves	raves
settings	settings
lat	lat
shocked	shocked
weaker	weaker
beings	beings
squirting	squirting
bolivia	bolivia
outcome	outcome
hear	hear
predator	predator
requirements	requirements
traitorous	traitorous
mississippi	mississippi
mgs	mgs
metric	metric
jug	jug
position	position
circles	circles
wag	wag
guardians	guardians
pokes	pokes
teared	teared
needlessly	needlessly
decaf	decaf
whipped	whipped
sesame	sesame
clashes	clashes
peter	peter
barber	barber
troubling	troubling
studs	studs
stylist	stylist
profit	profit
shocker	shocker
tesla	tesla
encoding	encoding
exported	exported
passionately	passionately
accusing	accusing
smells	smells
commotion	commotion
process	process
furnace	furnace
lorry	lorry
constantine	constantine
dawned	dawned
historical	historical
soundtracks	soundtracks
e-mails	e-mails
inventive	inventive
trough	trough
induction	induction
recess	recess
dyer	dyer
firearm	firearm
windows	windows
reptilian	reptilian
vectors	vectors
matched	matched
estimated	estimated
formulas	formulas
swallow	swallow
appease	appease
mourning	mourning
weirder	weirder
mathematical	mathematical
fiscal	fiscal
bling	bling
player	player
buss	buss
cardiff	cardiff
kms	kms
representations	representations
lifesaver	lifesaver
dubbed	dubbed
dill	dill
toes	toes
stallion	stallion
riffs	riffs
silky	silky
tv	tv
merging	merging
ripping	ripping
zodiac	zodiac
deeds	deeds
vendetta	vendetta
sinks	sinks
wolves	wolves
grins	grins
boasts	boasts
tread	tread
slimmer	slimmer
current	current
statement	statement
acknowledged	acknowledged
cleansed	cleansed
morning	morning
fossils	fossils
hypocrite	hypocrite
considerate	considerate
driven	driven
its	its
accessing	accessing
bone	bone
prohibits	prohibits
prohibition	prohibition
romance	romance
disaster	disaster
brought	brought
averaging	averaging
disappoint	disappoint
realise	realise
children	children
begins	begins
cervix	cervix
victoria	victoria
nog	nog
seeding	seeding
farming	farming
schooling	schooling
lion	lion
militia	militia
charter	charter
uptight	uptight
spades	spades
sb	sb
jarring	jarring
embody	embody
weiss	weiss
modification	modification
occult	occult
sapiens	sapiens
gladiator	gladiator
carats	carats
breathless	breathless
attempt	attempt
monkeys	monkeys
peak	peak
baba	baba
arches	arches
fleeing	fleeing
accommodations	accommodations
nuzzles	nuzzles
trouble	trouble
dana	dana
fog	fog
refreshments	refreshments
talks	talks
fictitious	fictitious
delayed	delayed
walters	walters
jab	jab
librarian	librarian
testify	testify
glance	glance
ross	ross
mans	mans
jong	jong
complaints	complaints
truman	truman
concepts	concepts
gauge	gauge
montana	montana
riskier	riskier
kip	kip
unintentional	unintentional
indoors	indoors
raft	raft
oxide	oxide
fellowship	fellowship
differ	differ
etc.	etc.
prioritized	prioritized
cocktails	cocktails
unquestionably	unquestionably
animosity	animosity
cliches	cliches
blackmail	blackmail
socialists	socialists
entrances	entrances
shank	shank
migrate	migrate
rudely	rudely
factor	factor
owing	owing
sax	sax
clipper	clipper
homicide	homicide
salisbury	salisbury
pierre	pierre
breakout	breakout
roaming	roaming
bennett	bennett
respective	respective
mays	mays
richmond	richmond
exclamation	exclamation
sen	sen
therefor	therefor
yemen	yemen
unnecessary	unnecessary
autographs	autographs
obedient	obedient
creep	creep
cleaners	cleaners
wonderful	wonderful
thirdly	thirdly
spatial	spatial
signed	signed
socializing	socializing
least	least
demean	demean
tortilla	tortilla
undefeated	undefeated
consecutive	consecutive
unusual	unusual
chalice	chalice
infected	infected
sneaker	sneaker
peaked	peaked
mural	mural
greedy	greedy
memphis	memphis
gulp	gulp
mentions	mentions
tech	tech
lovelies	lovelies
contest	contest
canadian	canadian
furry	furry
confidence	confidence
fermented	fermented
dip	dip
ew	ew
painter	painter
summed	summed
crock	crock
deutschland	deutschland
galaxies	galaxies
tackle	tackle
brushing	brushing
tents	tents
exhale	exhale
iii	iii
corsair	corsair
stab	stab
reliability	reliability
renting	renting
red	red
option	option
philippians	philippians
humanities	humanities
piqued	piqued
recluse	recluse
poorest	poorest
memberships	memberships
clerics	clerics
chops	chops
some	some
playoffs	playoffs
charging	charging
unreleased	unreleased
extended	extended
gist	gist
coordinator	coordinator
cemented	cemented
habitat	habitat
syndicate	syndicate
warmed	warmed
emptiness	emptiness
morrigan	morrigan
skin	skin
facets	facets
critics	critics
scriptures	scriptures
owes	owes
le	le
overtake	overtake
scene	scene
fletcher	fletcher
exclaimed	exclaimed
muhammad	muhammad
performance	performance
behold	behold
owls	owls
obsessions	obsessions
chestnut	chestnut
d	d
spire	spire
reclaiming	reclaiming
body	body
decor	decor
legitimacy	legitimacy
peers	peers
cusp	cusp
takeaway	takeaway
ambiguous	ambiguous
decal	decal
nowadays	nowadays
gentle	gentle
clowning	clowning
northerners	northerners
cultivating	cultivating
escapism	escapism
punt	punt
pointer	pointer
look	look
sparring	sparring
population	population
blinks	blinks
weighs	weighs
sensitivity	sensitivity
failings	failings
srs	srs
dangers	dangers
draped	draped
jerry	jerry
cancun	cancun
study	study
ccc	ccc
theoretically	theoretically
dictators	dictators
overs	overs
wanking	wanking
fibre	fibre
perpetrators	perpetrators
spf	spf
wheel	wheel
rebate	rebate
stacks	stacks
deadliest	deadliest
thermodynamics	thermodynamics
whispered	whispered
stripes	stripes
sap	sap
devastation	devastation
databases	databases
potent	potent
tl	tl
overplayed	overplayed
recycle	recycle
libertarianism	libertarianism
dioxide	dioxide
legalizing	legalizing
vocational	vocational
bjs	bjs
ply	ply
announcement	announcement
breweries	breweries
sneak	sneak
moreover	moreover
intimately	intimately
kickoff	kickoff
opinions	opinions
colonies	colonies
inmates	inmates
filthy	filthy
oder	oder
mistreat	mistreat
stockings	stockings
chucks	chucks
disasters	disasters
panned	panned
tolerate	tolerate
glorious	glorious
asbestos	asbestos
built	built
lionesses	lionesses
trimester	trimester
courts	courts
comparative	comparative
thanking	thanking
macedonia	macedonia
refute	refute
flagged	flagged
albums	albums
creeped	creeped
anchored	anchored
equipped	equipped
unlawful	unlawful
asparagus	asparagus
teams	teams
crashing	crashing
manila	manila
illuminate	illuminate
configured	configured
hearsay	hearsay
uneasy	uneasy
grumps	grumps
dank	dank
moniker	moniker
scandals	scandals
curiously	curiously
boar	boar
eta	eta
torque	torque
photographers	photographers
color	color
blinded	blinded
widen	widen
trace	trace
whine	whine
yang	yang
deploy	deploy
bacteria	bacteria
assuming	assuming
impossible	impossible
deficit	deficit
pertinent	pertinent
urgent	urgent
nosey	nosey
ruling	ruling
manhood	manhood
restructuring	restructuring
bows	bows
bumps	bumps
tylenol	tylenol
voyager	voyager
picked	picked
toner	toner
ammo	ammo
shark	shark
warmer	warmer
consultancy	consultancy
sweats	sweats
snotty	snotty
falco	falco
trick	trick
instructed	instructed
vending	vending
top	top
vaccines	vaccines
apologizes	apologizes
athena	athena
forest	forest
boosts	boosts
pent	pent
canister	canister
rounded	rounded
v	v
does	does
survive	survive
gluttony	gluttony
hela	hela
hunk	hunk
whims	whims
picturing	picturing
planing	planing
apartment	apartment
mn	mn
equations	equations
friedman	friedman
placebo	placebo
icons	icons
escorting	escorting
mashing	mashing
right-wing	right-wing
surveillance	surveillance
omega	omega
trophy	trophy
economist	economist
coax	coax
pillow	pillow
speaks	speaks
muse	muse
undergrad	undergrad
deliveries	deliveries
coalition	coalition
tentacle	tentacle
agent	agent
tournaments	tournaments
debated	debated
refill	refill
flexible	flexible
nj	nj
london	london
lectures	lectures
gunner	gunner
sleigh	sleigh
exists	exists
roe	roe
reproducing	reproducing
families	families
dosage	dosage
kids	kids
begrudge	begrudge
ivory	ivory
thresholds	thresholds
bee	bee
goods	goods
ideals	ideals
golds	golds
rifles	rifles
crooked	crooked
angular	angular
dawson	dawson
liquids	liquids
ultima	ultima
hill	hill
founded	founded
besides	besides
pricks	pricks
japanese	japanese
negotiation	negotiation
encourage	encourage
shrieking	shrieking
reveal	reveal
profanity	profanity
isolation	isolation
dortmund	dortmund
seventy	seventy
euros	euros
unfortunate	unfortunate
stages	stages
prowess	prowess
static	static
infatuation	infatuation
frankenstein	frankenstein
teleprompter	teleprompter
brass	brass
spray	spray
radar	radar
dominos	dominos
decorum	decorum
louisville	louisville
shed	shed
who	who
glares	glares
snapshot	snapshot
gents	gents
announcing	announcing
noteworthy	noteworthy
robs	robs
wrestle	wrestle
hookers	hookers
bey	bey
propped	propped
confuse	confuse
fives	fives
everyday	everyday
reinstated	reinstated
originally	originally
umpire	umpire
consented	consented
diplomatic	diplomatic
preferences	preferences
someday	someday
patrons	patrons
retreating	retreating
knitting	knitting
drill	drill
charles	charles
beginning	beginning
anthems	anthems
roses	roses
batted	batted
disabled	disabled
buggy	buggy
workings	workings
timid	timid
stealthy	stealthy
miracle	miracle
sufficient	sufficient
wiz	wiz
exposures	exposures
timers	timers
cholesterol	cholesterol
headphone	headphone
slam	slam
elevators	elevators
incidental	incidental
underestimate	underestimate
crutch	crutch
metro	metro
fixated	fixated
ice	ice
reasonable	reasonable
dieing	dieing
chef	chef
derangement	derangement
hart	hart
highlighter	highlighter
rye	rye
drowned	drowned
debate	debate
rodeo	rodeo
hive	hive
indianapolis	indianapolis
overgrown	overgrown
cleansing	cleansing
revolved	revolved
clockwork	clockwork
das	das
misunderstood	misunderstood
supplier	supplier
adaptor	adaptor
tactically	tactically
subscriptions	subscriptions
bathtub	bathtub
selecting	selecting
confirms	confirms
internment	internment
thigh	thigh
rushed	rushed
cooke	cooke
untouchable	untouchable
opposites	opposites
intestines	intestines
outwardly	outwardly
crucify	crucify
rug	rug
evangelical	evangelical
lose	lose
partnering	partnering
holiday	holiday
ensure	ensure
duos	duos
oscar	oscar
interruptions	interruptions
mums	mums
boosters	boosters
apologists	apologists
rightfully	rightfully
efficiency	efficiency
woefully	woefully
edwin	edwin
disparate	disparate
pike	pike
infer	infer
sensations	sensations
advent	advent
replica	replica
tnt	tnt
sidelines	sidelines
frostbite	frostbite
art	art
nook	nook
innovative	innovative
genetics	genetics
seals	seals
egyptians	egyptians
inquiries	inquiries
arrogant	arrogant
sprain	sprain
realism	realism
congratulations	congratulations
startups	startups
idea	idea
solids	solids
dumbbells	dumbbells
install	install
pardoned	pardoned
israelis	israelis
labels	labels
spoiled	spoiled
obnoxiously	obnoxiously
subsequently	subsequently
karate	karate
rappers	rappers
checkmate	checkmate
browning	browning
stationary	stationary
fiscally	fiscally
clot	clot
schizophrenic	schizophrenic
palettes	palettes
breeds	breeds
incur	incur
authorized	authorized
hernia	hernia
nitpicking	nitpicking
centurion	centurion
renaming	renaming
comprised	comprised
yielded	yielded
below	below
game	game
correlate	correlate
meaningless	meaningless
relocated	relocated
whos	whos
miraculously	miraculously
throne	throne
journalistic	journalistic
promises	promises
winged	winged
taxable	taxable
worshipped	worshipped
mariners	mariners
paved	paved
stipulation	stipulation
reminisce	reminisce
revolving	revolving
gaping	gaping
informal	informal
criterion	criterion
pansexual	pansexual
fridays	fridays
indicating	indicating
jewish	jewish
twelve	twelve
humble	humble
nee	nee
cunt	cunt
mis	mis
criticize	criticize
theaters	theaters
rarely	rarely
loss	loss
smite	smite
overly	overly
sop	sop
grandpa	grandpa
dross	dross
skillet	skillet
marker	marker
cola	cola
spreadsheet	spreadsheet
cart	cart
interiors	interiors
pharmacist	pharmacist
oath	oath
stabilization	stabilization
narrowly	narrowly
horseback	horseback
foreheads	foreheads
stephens	stephens
classical	classical
vendors	vendors
mask	mask
reactions	reactions
unfaithful	unfaithful
harmful	harmful
gooey	gooey
missile	missile
repay	repay
deductible	deductible
cus	cus
disabilities	disabilities
groceries	groceries
collections	collections
swapping	swapping
uninterested	uninterested
clarification	clarification
missionary	missionary
fluctuations	fluctuations
transaction	transaction
restrictive	restrictive
soapbox	soapbox
unbroken	unbroken
crates	crates
imports	imports
marital	marital
unix	unix
tweeted	tweeted
slots	slots
stand-up	stand-up
blushing	blushing
bishop	bishop
cali	cali
buffed	buffed
vanessa	vanessa
diehard	diehard
mortified	mortified
dread	dread
pto	pto
stereotype	stereotype
find	find
boulder	boulder
nbs	nbs
venue	venue
greens	greens
atom	atom
isolated	isolated
enquire	enquire
haste	haste
school	school
pts	pts
mfa	mfa
environments	environments
negotiator	negotiator
driving	driving
borrow	borrow
holly	holly
cs	cs
torment	torment
shippers	shippers
monopoly	monopoly
snuggles	snuggles
bandana	bandana
deliverance	deliverance
upbringing	upbringing
boundaries	boundaries
pittsburgh	pittsburgh
flowers	flowers
phrases	phrases
browns	browns
rg	rg
copping	copping
downs	downs
looked	looked
overestimate	overestimate
ball	ball
ropes	ropes
asinine	asinine
calculating	calculating
decision	decision
globalization	globalization
confederate	confederate
sockets	sockets
shiv	shiv
suitably	suitably
lookup	lookup
community	community
passengers	passengers
homers	homers
balding	balding
critters	critters
pirating	pirating
unparalleled	unparalleled
gentleman	gentleman
crossword	crossword
contraction	contraction
temper	temper
at	at
ways	ways
rescue	rescue
mason	mason
writers	writers
waning	waning
airbus	airbus
vulture	vulture
gel	gel
cid	cid
safeguarding	safeguarding
splendid	splendid
suing	suing
tug	tug
reimburse	reimburse
recoup	recoup
inquisitor	inquisitor
bounces	bounces
focussed	focussed
stubs	stubs
firefly	firefly
breach	breach
fractional	fractional
bitchy	bitchy
vitamins	vitamins
shaggy	shaggy
mccartney	mccartney
ghostly	ghostly
ragnarok	ragnarok
linear	linear
patrick	patrick
ppp	ppp
constrained	constrained
howdy	howdy
platter	platter
lockers	lockers
brooks	brooks
april	april
plural	plural
training	training
palette	palette
disciplines	disciplines
directs	directs
dispel	dispel
recipients	recipients
loch	loch
shape	shape
proudest	proudest
c	c
dying	dying
janitor	janitor
spraying	spraying
philadelphia	philadelphia
comic	comic
capping	capping
neighbors	neighbors
founding	founding
inspection	inspection
sucking	sucking
looters	looters
groupie	groupie
functional	functional
inventor	inventor
bowls	bowls
